# # # # # # # # # # # # #
# _ _ _ _ _ _ _ _ _ _ _ #
# _ _ _ _ _ _ _ _ _ _ _ #
# _ _ _ _ _ _ _ _ _ _ _ #
# _ _ _ # # # # # _ _ _ #
# _ _ _ # 3 0 5 # _ _ _ #
# _ _ _ # 0 1 2 # _ _ _ #
# _ _ _ # 1 9 5 # _ _ _ #
# _ _ _ # # # # # _ _ _ #
# _ _ _ _ _ _ _ _ _ _ _ #
# _ _ _ _ _ _ _ _ _ _ _ #
# _ _ _ _ _ _ _ _ _ _ _ #
# # # # # # # # # # # # #